"filename", "language", "XML", "C#", "JSON", "Ini", "comment", "blank", "total"
"e:\OneDrive\Gitee\pilot.SCADA\pilot.SCADA\pilot.SCADA\App.xaml", "XML", 18, 0, 0, 0, 0, 3, 21
"e:\OneDrive\Gitee\pilot.SCADA\pilot.SCADA\pilot.SCADA\App.xaml.cs", "C#", 0, 13, 0, 0, 3, 2, 18
"e:\OneDrive\Gitee\pilot.SCADA\pilot.SCADA\pilot.SCADA\Assets\img\boat.svg", "XML", 1924, 0, 0, 0, 0, 0, 1924
"e:\OneDrive\Gitee\pilot.SCADA\pilot.SCADA\pilot.SCADA\Assets\img\boat2.svg", "XML", 2194, 0, 0, 0, 0, 0, 2194
"e:\OneDrive\Gitee\pilot.SCADA\pilot.SCADA\pilot.SCADA\Assets\img\boat4.svg", "XML", 2190, 0, 0, 0, 0, 0, 2190
"e:\OneDrive\Gitee\pilot.SCADA\pilot.SCADA\pilot.SCADA\Assets\img\car.svg", "XML", 1, 0, 0, 0, 0, 0, 1
"e:\OneDrive\Gitee\pilot.SCADA\pilot.SCADA\pilot.SCADA\Assets\theme\ResourceDictionary.xaml", "XML", 3, 0, 0, 0, 0, 1, 4
"e:\OneDrive\Gitee\pilot.SCADA\pilot.SCADA\pilot.SCADA\Converter\InverseBoolConverter.cs", "C#", 0, 17, 0, 0, 3, 3, 23
"e:\OneDrive\Gitee\pilot.SCADA\pilot.SCADA\pilot.SCADA\Converter\ListAddIndexConverter.cs", "C#", 0, 35, 0, 0, 3, 5, 43
"e:\OneDrive\Gitee\pilot.SCADA\pilot.SCADA\pilot.SCADA\Converter\ListArray2StrListConverter.cs", "C#", 0, 44, 0, 0, 0, 8, 52
"e:\OneDrive\Gitee\pilot.SCADA\pilot.SCADA\pilot.SCADA\Converter\LogBackGroundConverter.cs", "C#", 0, 31, 0, 0, 0, 3, 34
"e:\OneDrive\Gitee\pilot.SCADA\pilot.SCADA\pilot.SCADA\Global\ActionMessage.cs", "C#", 0, 39, 0, 0, 11, 6, 56
"e:\OneDrive\Gitee\pilot.SCADA\pilot.SCADA\pilot.SCADA\Global\BasePath.cs", "C#", 0, 13, 0, 0, 1, 5, 19
"e:\OneDrive\Gitee\pilot.SCADA\pilot.SCADA\pilot.SCADA\Global\GlobalValues.cs", "C#", 0, 15, 0, 0, 6, 3, 24
"e:\OneDrive\Gitee\pilot.SCADA\pilot.SCADA\pilot.SCADA\Global\Registrant.cs", "C#", 0, 12, 0, 0, 1, 2, 15
"e:\OneDrive\Gitee\pilot.SCADA\pilot.SCADA\pilot.SCADA\Global\SensorManager.cs", "C#", 0, 42, 0, 0, 8, 8, 58
"e:\OneDrive\Gitee\pilot.SCADA\pilot.SCADA\pilot.SCADA\Models\ConstantChangesChartModel.cs", "C#", 0, 25, 0, 0, 0, 4, 29
"e:\OneDrive\Gitee\pilot.SCADA\pilot.SCADA\pilot.SCADA\Models\DBloginModel.cs", "C#", 0, 67, 0, 0, 15, 6, 88
"e:\OneDrive\Gitee\pilot.SCADA\pilot.SCADA\pilot.SCADA\Models\DataCheckModel.cs", "C#", 0, 15, 0, 0, 18, 7, 40
"e:\OneDrive\Gitee\pilot.SCADA\pilot.SCADA\pilot.SCADA\Models\GroupModel.cs", "C#", 0, 40, 0, 0, 6, 7, 53
"e:\OneDrive\Gitee\pilot.SCADA\pilot.SCADA\pilot.SCADA\Models\ModbusMasterModel.cs", "C#", 0, 212, 0, 0, 43, 33, 288
"e:\OneDrive\Gitee\pilot.SCADA\pilot.SCADA\pilot.SCADA\Models\ProjectRecordModel.cs", "C#", 0, 15, 0, 0, 6, 6, 27
"e:\OneDrive\Gitee\pilot.SCADA\pilot.SCADA\pilot.SCADA\Models\SensorModel.cs", "C#", 0, 154, 0, 0, 29, 22, 205
"e:\OneDrive\Gitee\pilot.SCADA\pilot.SCADA\pilot.SCADA\Models\SeosorManagerModel.cs", "C#", 0, 13, 0, 0, 1, 3, 17
"e:\OneDrive\Gitee\pilot.SCADA\pilot.SCADA\pilot.SCADA\Models\TaskFlowModel.cs", "C#", 0, 15, 0, 0, 14, 3, 32
"e:\OneDrive\Gitee\pilot.SCADA\pilot.SCADA\pilot.SCADA\Models\TaskModuleModel.cs", "C#", 0, 15, 0, 0, 0, 2, 17
"e:\OneDrive\Gitee\pilot.SCADA\pilot.SCADA\pilot.SCADA\Properties\AssemblyInfo.cs", "C#", 0, 20, 0, 0, 27, 9, 56
"e:\OneDrive\Gitee\pilot.SCADA\pilot.SCADA\pilot.SCADA\Properties\Resources.Designer.cs", "C#", 0, 33, 0, 0, 22, 9, 64
"e:\OneDrive\Gitee\pilot.SCADA\pilot.SCADA\pilot.SCADA\Properties\Settings.Designer.cs", "C#", 0, 13, 0, 0, 8, 6, 27
"e:\OneDrive\Gitee\pilot.SCADA\pilot.SCADA\pilot.SCADA\ViewModels\ConnectDBViewModel.cs", "C#", 0, 105, 0, 0, 22, 18, 145
"e:\OneDrive\Gitee\pilot.SCADA\pilot.SCADA\pilot.SCADA\ViewModels\ConstantChangesChartViewModel.cs", "C#", 0, 31, 0, 0, 0, 6, 37
"e:\OneDrive\Gitee\pilot.SCADA\pilot.SCADA\pilot.SCADA\ViewModels\CreateSensorViewModel.cs", "C#", 0, 86, 0, 0, 16, 9, 111
"e:\OneDrive\Gitee\pilot.SCADA\pilot.SCADA\pilot.SCADA\ViewModels\DataCheckViewModel.cs", "C#", 0, 128, 0, 0, 34, 32, 194
"e:\OneDrive\Gitee\pilot.SCADA\pilot.SCADA\pilot.SCADA\ViewModels\MainViewModel.cs", "C#", 0, 431, 0, 0, 68, 61, 560
"e:\OneDrive\Gitee\pilot.SCADA\pilot.SCADA\pilot.SCADA\ViewModels\ModbusMasterViewModel.cs", "C#", 0, 161, 0, 0, 28, 29, 218
"e:\OneDrive\Gitee\pilot.SCADA\pilot.SCADA\pilot.SCADA\ViewModels\NewProjectViewModel.cs", "C#", 0, 154, 0, 0, 26, 27, 207
"e:\OneDrive\Gitee\pilot.SCADA\pilot.SCADA\pilot.SCADA\ViewModels\ProjectManagViewModel.cs", "C#", 0, 171, 0, 0, 27, 34, 232
"e:\OneDrive\Gitee\pilot.SCADA\pilot.SCADA\pilot.SCADA\ViewModels\RecentProjectViewModel.cs", "C#", 0, 43, 0, 0, 11, 5, 59
"e:\OneDrive\Gitee\pilot.SCADA\pilot.SCADA\pilot.SCADA\ViewModels\SelectTaskViewModel.cs", "C#", 0, 88, 0, 0, 15, 19, 122
"e:\OneDrive\Gitee\pilot.SCADA\pilot.SCADA\pilot.SCADA\ViewModels\SensorManagerViewModel.cs", "C#", 0, 178, 0, 0, 125, 43, 346
"e:\OneDrive\Gitee\pilot.SCADA\pilot.SCADA\pilot.SCADA\ViewModels\TaskFlowManageViewModel.cs", "C#", 0, 105, 0, 0, 52, 26, 183
"e:\OneDrive\Gitee\pilot.SCADA\pilot.SCADA\pilot.SCADA\ViewModels\TaskProcessViewModel.cs", "C#", 0, 72, 0, 0, 7, 17, 96
"e:\OneDrive\Gitee\pilot.SCADA\pilot.SCADA\pilot.SCADA\ViewModels\TaskViewModel.cs", "C#", 0, 46, 0, 0, 9, 7, 62
"e:\OneDrive\Gitee\pilot.SCADA\pilot.SCADA\pilot.SCADA\ViewModels\TiledCheckViewModel.cs", "C#", 0, 97, 0, 0, 24, 20, 141
"e:\OneDrive\Gitee\pilot.SCADA\pilot.SCADA\pilot.SCADA\ViewModels\TiledViewModel.cs", "C#", 0, 36, 0, 0, 3, 9, 48
"e:\OneDrive\Gitee\pilot.SCADA\pilot.SCADA\pilot.SCADA\ViewModels\ViewModelLocator.cs", "C#", 0, 66, 0, 0, 18, 19, 103
"e:\OneDrive\Gitee\pilot.SCADA\pilot.SCADA\pilot.SCADA\Views\BluePrintView.xaml", "XML", 65, 0, 0, 0, 5, 9, 79
"e:\OneDrive\Gitee\pilot.SCADA\pilot.SCADA\pilot.SCADA\Views\BluePrintView.xaml.cs", "C#", 0, 148, 0, 0, 32, 32, 212
"e:\OneDrive\Gitee\pilot.SCADA\pilot.SCADA\pilot.SCADA\Views\ConnectDBView.xaml", "XML", 55, 0, 0, 0, 0, 12, 67
"e:\OneDrive\Gitee\pilot.SCADA\pilot.SCADA\pilot.SCADA\Views\ConnectDBView.xaml.cs", "C#", 0, 27, 0, 0, 3, 3, 33
"e:\OneDrive\Gitee\pilot.SCADA\pilot.SCADA\pilot.SCADA\Views\CreateSensorView.xaml", "XML", 182, 0, 0, 0, 7, 25, 214
"e:\OneDrive\Gitee\pilot.SCADA\pilot.SCADA\pilot.SCADA\Views\CreateSensorView.xaml.cs", "C#", 0, 27, 0, 0, 3, 5, 35
"e:\OneDrive\Gitee\pilot.SCADA\pilot.SCADA\pilot.SCADA\Views\DataCheckView.xaml", "XML", 69, 0, 0, 0, 1, 11, 81
"e:\OneDrive\Gitee\pilot.SCADA\pilot.SCADA\pilot.SCADA\Views\DataCheckView.xaml.cs", "C#", 0, 27, 0, 0, 3, 2, 32
"e:\OneDrive\Gitee\pilot.SCADA\pilot.SCADA\pilot.SCADA\Views\DragButton.cs", "C#", 0, 75, 0, 0, 20, 10, 105
"e:\OneDrive\Gitee\pilot.SCADA\pilot.SCADA\pilot.SCADA\Views\LogView.xaml", "XML", 45, 0, 0, 0, 0, 5, 50
"e:\OneDrive\Gitee\pilot.SCADA\pilot.SCADA\pilot.SCADA\Views\LogView.xaml.cs", "C#", 0, 23, 0, 0, 3, 2, 28
"e:\OneDrive\Gitee\pilot.SCADA\pilot.SCADA\pilot.SCADA\Views\MainView.xaml", "XML", 330, 0, 0, 0, 19, 47, 396
"e:\OneDrive\Gitee\pilot.SCADA\pilot.SCADA\pilot.SCADA\Views\MainView.xaml.cs", "C#", 0, 40, 0, 0, 3, 3, 46
"e:\OneDrive\Gitee\pilot.SCADA\pilot.SCADA\pilot.SCADA\Views\ModBusGuideView.xaml", "XML", 150, 0, 0, 0, 3, 28, 181
"e:\OneDrive\Gitee\pilot.SCADA\pilot.SCADA\pilot.SCADA\Views\ModBusGuideView.xaml.cs", "C#", 0, 27, 0, 0, 3, 3, 33
"e:\OneDrive\Gitee\pilot.SCADA\pilot.SCADA\pilot.SCADA\Views\ModbusReadSetView.xaml", "XML", 62, 0, 0, 0, 0, 12, 74
"e:\OneDrive\Gitee\pilot.SCADA\pilot.SCADA\pilot.SCADA\Views\ModbusReadSetView.xaml.cs", "C#", 0, 27, 0, 0, 3, 3, 33
"e:\OneDrive\Gitee\pilot.SCADA\pilot.SCADA\pilot.SCADA\Views\NewProjectView.xaml", "XML", 62, 0, 0, 0, 0, 12, 74
"e:\OneDrive\Gitee\pilot.SCADA\pilot.SCADA\pilot.SCADA\Views\NewProjectView.xaml.cs", "C#", 0, 24, 0, 0, 3, 2, 29
"e:\OneDrive\Gitee\pilot.SCADA\pilot.SCADA\pilot.SCADA\Views\NodeConfigView.xaml", "XML", 72, 0, 0, 0, 0, 7, 79
"e:\OneDrive\Gitee\pilot.SCADA\pilot.SCADA\pilot.SCADA\Views\NodeConfigView.xaml.cs", "C#", 0, 23, 0, 0, 3, 2, 28
"e:\OneDrive\Gitee\pilot.SCADA\pilot.SCADA\pilot.SCADA\Views\PluginView.xaml", "XML", 35, 0, 0, 0, 1, 1, 37
"e:\OneDrive\Gitee\pilot.SCADA\pilot.SCADA\pilot.SCADA\Views\PluginView.xaml.cs", "C#", 0, 33, 0, 0, 22, 7, 62
"e:\OneDrive\Gitee\pilot.SCADA\pilot.SCADA\pilot.SCADA\Views\PrjItem.xaml", "XML", 37, 0, 0, 0, 2, 5, 44
"e:\OneDrive\Gitee\pilot.SCADA\pilot.SCADA\pilot.SCADA\Views\PrjItem.xaml.cs", "C#", 0, 63, 0, 0, 12, 9, 84
"e:\OneDrive\Gitee\pilot.SCADA\pilot.SCADA\pilot.SCADA\Views\ProjectManagView.xaml", "XML", 102, 0, 0, 0, 5, 19, 126
"e:\OneDrive\Gitee\pilot.SCADA\pilot.SCADA\pilot.SCADA\Views\ProjectManagView.xaml.cs", "C#", 0, 27, 0, 0, 3, 2, 32
"e:\OneDrive\Gitee\pilot.SCADA\pilot.SCADA\pilot.SCADA\Views\SelectTaskView.xaml", "XML", 74, 0, 0, 0, 0, 7, 81
"e:\OneDrive\Gitee\pilot.SCADA\pilot.SCADA\pilot.SCADA\Views\SelectTaskView.xaml.cs", "C#", 0, 29, 0, 0, 4, 5, 38
"e:\OneDrive\Gitee\pilot.SCADA\pilot.SCADA\pilot.SCADA\Views\SensorManagerView.xaml", "XML", 67, 0, 0, 0, 21, 12, 100
"e:\OneDrive\Gitee\pilot.SCADA\pilot.SCADA\pilot.SCADA\Views\SensorManagerView.xaml.cs", "C#", 0, 27, 0, 0, 3, 2, 32
"e:\OneDrive\Gitee\pilot.SCADA\pilot.SCADA\pilot.SCADA\Views\TaskFlowManageView.xaml", "XML", 36, 0, 0, 0, 4, 5, 45
"e:\OneDrive\Gitee\pilot.SCADA\pilot.SCADA\pilot.SCADA\Views\TaskFlowManageView.xaml.cs", "C#", 0, 24, 0, 0, 3, 2, 29
"e:\OneDrive\Gitee\pilot.SCADA\pilot.SCADA\pilot.SCADA\Views\TaskPreviewView.xaml", "XML", 13, 0, 0, 0, 0, 1, 14
"e:\OneDrive\Gitee\pilot.SCADA\pilot.SCADA\pilot.SCADA\Views\TaskPreviewView.xaml.cs", "C#", 0, 24, 0, 0, 3, 2, 29
"e:\OneDrive\Gitee\pilot.SCADA\pilot.SCADA\pilot.SCADA\Views\TaskProcessView.xaml", "XML", 26, 0, 0, 0, 0, 6, 32
"e:\OneDrive\Gitee\pilot.SCADA\pilot.SCADA\pilot.SCADA\Views\TaskProcessView.xaml.cs", "C#", 0, 25, 0, 0, 3, 2, 30
"e:\OneDrive\Gitee\pilot.SCADA\pilot.SCADA\pilot.SCADA\Views\TaskView.xaml", "XML", 521, 0, 0, 0, 47, 123, 691
"e:\OneDrive\Gitee\pilot.SCADA\pilot.SCADA\pilot.SCADA\Views\TaskView.xaml.cs", "C#", 0, 122, 0, 0, 13, 17, 152
"e:\OneDrive\Gitee\pilot.SCADA\pilot.SCADA\pilot.SCADA\Views\TiledItemView.xaml", "XML", 66, 0, 0, 0, 0, 10, 76
"e:\OneDrive\Gitee\pilot.SCADA\pilot.SCADA\pilot.SCADA\Views\TiledItemView.xaml.cs", "C#", 0, 24, 0, 0, 3, 2, 29
"e:\OneDrive\Gitee\pilot.SCADA\pilot.SCADA\pilot.SCADA\Views\TiledView.xaml", "XML", 22, 0, 0, 0, 10, 4, 36
"e:\OneDrive\Gitee\pilot.SCADA\pilot.SCADA\pilot.SCADA\Views\TiledView.xaml.cs", "C#", 0, 31, 0, 0, 14, 9, 54
"e:\OneDrive\Gitee\pilot.SCADA\pilot.SCADA\pilot.SCADA\Views\view2.xaml", "XML", 16, 0, 0, 0, 0, 1, 17
"e:\OneDrive\Gitee\pilot.SCADA\pilot.SCADA\pilot.SCADA\Views\view2.xaml.cs", "C#", 0, 27, 0, 0, 3, 3, 33
"e:\OneDrive\Gitee\pilot.SCADA\pilot.SCADA\pilot.SCADA\bin\Debug\Cfg\.vs\VSWorkspaceState.json", "JSON", 0, 0, 6, 0, 0, 0, 6
"e:\OneDrive\Gitee\pilot.SCADA\pilot.SCADA\pilot.SCADA\bin\Debug\Cfg\DBConfig.json", "JSON", 0, 0, 1, 0, 0, 0, 1
"e:\OneDrive\Gitee\pilot.SCADA\pilot.SCADA\pilot.SCADA\bin\Debug\Cfg\DefaultPrjPath.json", "JSON", 0, 0, 1, 0, 0, 0, 1
"e:\OneDrive\Gitee\pilot.SCADA\pilot.SCADA\pilot.SCADA\bin\Debug\Cfg\ProjectRecordList.json", "JSON", 0, 0, 1, 0, 0, 0, 1
"e:\OneDrive\Gitee\pilot.SCADA\pilot.SCADA\pilot.SCADA\bin\Debug\GalaSoft.MvvmLight.Extras.xml", "XML", 465, 0, 0, 0, 0, 1, 466
"e:\OneDrive\Gitee\pilot.SCADA\pilot.SCADA\pilot.SCADA\bin\Debug\GalaSoft.MvvmLight.Platform.xml", "XML", 350, 0, 0, 0, 0, 1, 351
"e:\OneDrive\Gitee\pilot.SCADA\pilot.SCADA\pilot.SCADA\bin\Debug\GalaSoft.MvvmLight.xml", "XML", 1812, 0, 0, 0, 0, 1, 1813
"e:\OneDrive\Gitee\pilot.SCADA\pilot.SCADA\pilot.SCADA\bin\Debug\HandyControl.xml", "XML", 3504, 0, 0, 0, 0, 1, 3505
"e:\OneDrive\Gitee\pilot.SCADA\pilot.SCADA\pilot.SCADA\bin\Debug\LiveCharts.Wpf.xml", "XML", 4199, 0, 0, 0, 0, 28, 4227
"e:\OneDrive\Gitee\pilot.SCADA\pilot.SCADA\pilot.SCADA\bin\Debug\LiveCharts.xml", "XML", 5403, 0, 0, 0, 0, 94, 5497
"e:\OneDrive\Gitee\pilot.SCADA\pilot.SCADA\pilot.SCADA\bin\Debug\Microsoft.Bcl.AsyncInterfaces.xml", "XML", 223, 0, 0, 0, 0, 1, 224
"e:\OneDrive\Gitee\pilot.SCADA\pilot.SCADA\pilot.SCADA\bin\Debug\Microsoft.WindowsAPICodePack.Shell.xml", "XML", 25309, 0, 0, 0, 0, 188, 25497
"e:\OneDrive\Gitee\pilot.SCADA\pilot.SCADA\pilot.SCADA\bin\Debug\Microsoft.WindowsAPICodePack.xml", "XML", 2931, 0, 0, 0, 0, 4, 2935
"e:\OneDrive\Gitee\pilot.SCADA\pilot.SCADA\pilot.SCADA\bin\Debug\NModbus.Serial.xml", "XML", 13, 0, 0, 0, 0, 1, 14
"e:\OneDrive\Gitee\pilot.SCADA\pilot.SCADA\pilot.SCADA\bin\Debug\NModbus.xml", "XML", 2039, 0, 0, 0, 0, 3, 2042
"e:\OneDrive\Gitee\pilot.SCADA\pilot.SCADA\pilot.SCADA\bin\Debug\Newtonsoft.Json.xml", "XML", 11305, 0, 0, 0, 0, 1, 11306
"e:\OneDrive\Gitee\pilot.SCADA\pilot.SCADA\pilot.SCADA\bin\Debug\SharpVectors.Converters.Wpf.xml", "XML", 3383, 0, 0, 0, 3, 3, 3389
"e:\OneDrive\Gitee\pilot.SCADA\pilot.SCADA\pilot.SCADA\bin\Debug\SharpVectors.Core.xml", "XML", 10946, 0, 0, 0, 2, 8, 10956
"e:\OneDrive\Gitee\pilot.SCADA\pilot.SCADA\pilot.SCADA\bin\Debug\SharpVectors.Css.xml", "XML", 1422, 0, 0, 0, 0, 1, 1423
"e:\OneDrive\Gitee\pilot.SCADA\pilot.SCADA\pilot.SCADA\bin\Debug\SharpVectors.Dom.xml", "XML", 307, 0, 0, 0, 0, 1, 308
"e:\OneDrive\Gitee\pilot.SCADA\pilot.SCADA\pilot.SCADA\bin\Debug\SharpVectors.Model.xml", "XML", 6600, 0, 0, 0, 5, 32, 6637
"e:\OneDrive\Gitee\pilot.SCADA\pilot.SCADA\pilot.SCADA\bin\Debug\SharpVectors.Rendering.Gdi.xml", "XML", 886, 0, 0, 0, 0, 3, 889
"e:\OneDrive\Gitee\pilot.SCADA\pilot.SCADA\pilot.SCADA\bin\Debug\SharpVectors.Rendering.Wpf.xml", "XML", 884, 0, 0, 0, 0, 19, 903
"e:\OneDrive\Gitee\pilot.SCADA\pilot.SCADA\pilot.SCADA\bin\Debug\SharpVectors.Runtime.Wpf.xml", "XML", 1096, 0, 0, 0, 0, 4, 1100
"e:\OneDrive\Gitee\pilot.SCADA\pilot.SCADA\pilot.SCADA\bin\Debug\System.Buffers.xml", "XML", 38, 0, 0, 0, 0, 0, 38
"e:\OneDrive\Gitee\pilot.SCADA\pilot.SCADA\pilot.SCADA\bin\Debug\System.Diagnostics.DiagnosticSource.xml", "XML", 424, 0, 0, 0, 0, 41, 465
"e:\OneDrive\Gitee\pilot.SCADA\pilot.SCADA\pilot.SCADA\bin\Debug\System.Memory.xml", "XML", 353, 0, 0, 0, 0, 2, 355
"e:\OneDrive\Gitee\pilot.SCADA\pilot.SCADA\pilot.SCADA\bin\Debug\System.Numerics.Vectors.xml", "XML", 2621, 0, 0, 0, 0, 0, 2621
"e:\OneDrive\Gitee\pilot.SCADA\pilot.SCADA\pilot.SCADA\bin\Debug\System.Runtime.CompilerServices.Unsafe.xml", "XML", 256, 0, 0, 0, 0, 2, 258
"e:\OneDrive\Gitee\pilot.SCADA\pilot.SCADA\pilot.SCADA\bin\Debug\System.Text.Encodings.Web.xml", "XML", 932, 0, 0, 0, 0, 4, 936
"e:\OneDrive\Gitee\pilot.SCADA\pilot.SCADA\pilot.SCADA\bin\Debug\System.Text.Json.xml", "XML", 2551, 0, 0, 0, 0, 110, 2661
"e:\OneDrive\Gitee\pilot.SCADA\pilot.SCADA\pilot.SCADA\bin\Debug\System.Threading.Tasks.Extensions.xml", "XML", 165, 0, 0, 0, 0, 1, 166
"e:\OneDrive\Gitee\pilot.SCADA\pilot.SCADA\pilot.SCADA\bin\Debug\System.ValueTuple.xml", "XML", 8, 0, 0, 0, 0, 1, 9
"e:\OneDrive\Gitee\pilot.SCADA\pilot.SCADA\pilot.SCADA\bin\Debug\com.ini", "Ini", 0, 0, 0, 12, 0, 5, 17
"e:\OneDrive\Gitee\pilot.SCADA\pilot.SCADA\pilot.SCADA\bin\Release\Cfg\DefaultPrjPath.json", "JSON", 0, 0, 1, 0, 0, 0, 1
"e:\OneDrive\Gitee\pilot.SCADA\pilot.SCADA\pilot.SCADA\bin\Release\Cfg\ProjectRecordList.json", "JSON", 0, 0, 1, 0, 0, 0, 1
"e:\OneDrive\Gitee\pilot.SCADA\pilot.SCADA\pilot.SCADA\bin\Release\GalaSoft.MvvmLight.Extras.xml", "XML", 465, 0, 0, 0, 0, 1, 466
"e:\OneDrive\Gitee\pilot.SCADA\pilot.SCADA\pilot.SCADA\bin\Release\GalaSoft.MvvmLight.Platform.xml", "XML", 350, 0, 0, 0, 0, 1, 351
"e:\OneDrive\Gitee\pilot.SCADA\pilot.SCADA\pilot.SCADA\bin\Release\GalaSoft.MvvmLight.xml", "XML", 1812, 0, 0, 0, 0, 1, 1813
"e:\OneDrive\Gitee\pilot.SCADA\pilot.SCADA\pilot.SCADA\bin\Release\HandyControl.xml", "XML", 3504, 0, 0, 0, 0, 1, 3505
"e:\OneDrive\Gitee\pilot.SCADA\pilot.SCADA\pilot.SCADA\bin\Release\LiveCharts.Wpf.xml", "XML", 4199, 0, 0, 0, 0, 28, 4227
"e:\OneDrive\Gitee\pilot.SCADA\pilot.SCADA\pilot.SCADA\bin\Release\LiveCharts.xml", "XML", 5403, 0, 0, 0, 0, 94, 5497
"e:\OneDrive\Gitee\pilot.SCADA\pilot.SCADA\pilot.SCADA\bin\Release\Microsoft.Bcl.AsyncInterfaces.xml", "XML", 223, 0, 0, 0, 0, 1, 224
"e:\OneDrive\Gitee\pilot.SCADA\pilot.SCADA\pilot.SCADA\bin\Release\Microsoft.WindowsAPICodePack.Shell.xml", "XML", 25309, 0, 0, 0, 0, 188, 25497
"e:\OneDrive\Gitee\pilot.SCADA\pilot.SCADA\pilot.SCADA\bin\Release\Microsoft.WindowsAPICodePack.xml", "XML", 2931, 0, 0, 0, 0, 4, 2935
"e:\OneDrive\Gitee\pilot.SCADA\pilot.SCADA\pilot.SCADA\bin\Release\NModbus.Serial.xml", "XML", 13, 0, 0, 0, 0, 1, 14
"e:\OneDrive\Gitee\pilot.SCADA\pilot.SCADA\pilot.SCADA\bin\Release\NModbus.xml", "XML", 2039, 0, 0, 0, 0, 3, 2042
"e:\OneDrive\Gitee\pilot.SCADA\pilot.SCADA\pilot.SCADA\bin\Release\Newtonsoft.Json.xml", "XML", 11305, 0, 0, 0, 0, 1, 11306
"e:\OneDrive\Gitee\pilot.SCADA\pilot.SCADA\pilot.SCADA\bin\Release\OxyPlot.Wpf.xml", "XML", 6625, 0, 0, 0, 0, 1, 6626
"e:\OneDrive\Gitee\pilot.SCADA\pilot.SCADA\pilot.SCADA\bin\Release\OxyPlot.xml", "XML", 22404, 0, 0, 0, 0, 1, 22405
"e:\OneDrive\Gitee\pilot.SCADA\pilot.SCADA\pilot.SCADA\bin\Release\SharpVectors.Converters.Wpf.xml", "XML", 3383, 0, 0, 0, 3, 3, 3389
"e:\OneDrive\Gitee\pilot.SCADA\pilot.SCADA\pilot.SCADA\bin\Release\SharpVectors.Core.xml", "XML", 10946, 0, 0, 0, 2, 8, 10956
"e:\OneDrive\Gitee\pilot.SCADA\pilot.SCADA\pilot.SCADA\bin\Release\SharpVectors.Css.xml", "XML", 1422, 0, 0, 0, 0, 1, 1423
"e:\OneDrive\Gitee\pilot.SCADA\pilot.SCADA\pilot.SCADA\bin\Release\SharpVectors.Dom.xml", "XML", 307, 0, 0, 0, 0, 1, 308
"e:\OneDrive\Gitee\pilot.SCADA\pilot.SCADA\pilot.SCADA\bin\Release\SharpVectors.Model.xml", "XML", 6600, 0, 0, 0, 5, 32, 6637
"e:\OneDrive\Gitee\pilot.SCADA\pilot.SCADA\pilot.SCADA\bin\Release\SharpVectors.Rendering.Gdi.xml", "XML", 886, 0, 0, 0, 0, 3, 889
"e:\OneDrive\Gitee\pilot.SCADA\pilot.SCADA\pilot.SCADA\bin\Release\SharpVectors.Rendering.Wpf.xml", "XML", 884, 0, 0, 0, 0, 19, 903
"e:\OneDrive\Gitee\pilot.SCADA\pilot.SCADA\pilot.SCADA\bin\Release\SharpVectors.Runtime.Wpf.xml", "XML", 1096, 0, 0, 0, 0, 4, 1100
"e:\OneDrive\Gitee\pilot.SCADA\pilot.SCADA\pilot.SCADA\bin\Release\System.Buffers.xml", "XML", 38, 0, 0, 0, 0, 0, 38
"e:\OneDrive\Gitee\pilot.SCADA\pilot.SCADA\pilot.SCADA\bin\Release\System.Diagnostics.DiagnosticSource.xml", "XML", 424, 0, 0, 0, 0, 41, 465
"e:\OneDrive\Gitee\pilot.SCADA\pilot.SCADA\pilot.SCADA\bin\Release\System.Memory.xml", "XML", 353, 0, 0, 0, 0, 2, 355
"e:\OneDrive\Gitee\pilot.SCADA\pilot.SCADA\pilot.SCADA\bin\Release\System.Numerics.Vectors.xml", "XML", 2621, 0, 0, 0, 0, 0, 2621
"e:\OneDrive\Gitee\pilot.SCADA\pilot.SCADA\pilot.SCADA\bin\Release\System.Runtime.CompilerServices.Unsafe.xml", "XML", 256, 0, 0, 0, 0, 2, 258
"e:\OneDrive\Gitee\pilot.SCADA\pilot.SCADA\pilot.SCADA\bin\Release\System.Text.Encodings.Web.xml", "XML", 932, 0, 0, 0, 0, 4, 936
"e:\OneDrive\Gitee\pilot.SCADA\pilot.SCADA\pilot.SCADA\bin\Release\System.Text.Json.xml", "XML", 2551, 0, 0, 0, 0, 110, 2661
"e:\OneDrive\Gitee\pilot.SCADA\pilot.SCADA\pilot.SCADA\bin\Release\System.Threading.Tasks.Extensions.xml", "XML", 165, 0, 0, 0, 0, 1, 166
"e:\OneDrive\Gitee\pilot.SCADA\pilot.SCADA\pilot.SCADA\bin\Release\System.ValueTuple.xml", "XML", 8, 0, 0, 0, 0, 1, 9
"e:\OneDrive\Gitee\pilot.SCADA\pilot.SCADA\pilot.SCADA\obj\Debug\.NETFramework,Version=v4.6.1.AssemblyAttributes.cs", "C#", 0, 3, 0, 0, 1, 1, 5
"e:\OneDrive\Gitee\pilot.SCADA\pilot.SCADA\pilot.SCADA\obj\Debug\.NETFramework,Version=v4.7.2.AssemblyAttributes.cs", "C#", 0, 3, 0, 0, 1, 1, 5
"e:\OneDrive\Gitee\pilot.SCADA\pilot.SCADA\pilot.SCADA\obj\Debug\App.g.cs", "C#", 0, 53, 0, 0, 18, 14, 85
"e:\OneDrive\Gitee\pilot.SCADA\pilot.SCADA\pilot.SCADA\obj\Debug\App.g.i.cs", "C#", 0, 53, 0, 0, 18, 14, 85
"e:\OneDrive\Gitee\pilot.SCADA\pilot.SCADA\pilot.SCADA\obj\Debug\GeneratedInternalTypeHelper.g.cs", "C#", 0, 27, 0, 0, 26, 10, 63
"e:\OneDrive\Gitee\pilot.SCADA\pilot.SCADA\pilot.SCADA\obj\Debug\GeneratedInternalTypeHelper.g.i.cs", "C#", 0, 27, 0, 0, 26, 10, 63
"e:\OneDrive\Gitee\pilot.SCADA\pilot.SCADA\pilot.SCADA\obj\Debug\MainWindow.g.i.cs", "C#", 0, 49, 0, 0, 15, 12, 76
"e:\OneDrive\Gitee\pilot.SCADA\pilot.SCADA\pilot.SCADA\obj\Debug\ViewsOther\CheckValueView.g.i.cs", "C#", 0, 122, 0, 0, 15, 33, 170
"e:\OneDrive\Gitee\pilot.SCADA\pilot.SCADA\pilot.SCADA\obj\Debug\ViewsOther\ConstantChangeChartTimeView.g.i.cs", "C#", 0, 50, 0, 0, 15, 12, 77
"e:\OneDrive\Gitee\pilot.SCADA\pilot.SCADA\pilot.SCADA\obj\Debug\ViewsOther\MainView.g.i.cs", "C#", 0, 129, 0, 0, 15, 34, 178
"e:\OneDrive\Gitee\pilot.SCADA\pilot.SCADA\pilot.SCADA\obj\Debug\ViewsOther\TiledView.g.i.cs", "C#", 0, 85, 0, 0, 15, 24, 124
"e:\OneDrive\Gitee\pilot.SCADA\pilot.SCADA\pilot.SCADA\obj\Debug\ViewsOther\view1.g.i.cs", "C#", 0, 49, 0, 0, 15, 12, 76
"e:\OneDrive\Gitee\pilot.SCADA\pilot.SCADA\pilot.SCADA\obj\Debug\ViewsOther\view2.g.i.cs", "C#", 0, 49, 0, 0, 15, 12, 76
"e:\OneDrive\Gitee\pilot.SCADA\pilot.SCADA\pilot.SCADA\obj\Debug\Views\AddSerialObjView.g.i.cs", "C#", 0, 110, 0, 0, 15, 33, 158
"e:\OneDrive\Gitee\pilot.SCADA\pilot.SCADA\pilot.SCADA\obj\Debug\Views\BluePrintView.g.cs", "C#", 0, 131, 0, 0, 15, 41, 187
"e:\OneDrive\Gitee\pilot.SCADA\pilot.SCADA\pilot.SCADA\obj\Debug\Views\BluePrintView.g.i.cs", "C#", 0, 131, 0, 0, 15, 41, 187
"e:\OneDrive\Gitee\pilot.SCADA\pilot.SCADA\pilot.SCADA\obj\Debug\Views\CheckValueView.g.i.cs", "C#", 0, 122, 0, 0, 15, 33, 170
"e:\OneDrive\Gitee\pilot.SCADA\pilot.SCADA\pilot.SCADA\obj\Debug\Views\ChooseComView.g.i.cs", "C#", 0, 86, 0, 0, 15, 24, 125
"e:\OneDrive\Gitee\pilot.SCADA\pilot.SCADA\pilot.SCADA\obj\Debug\Views\ConnectDBView.g.cs", "C#", 0, 78, 0, 0, 15, 17, 110
"e:\OneDrive\Gitee\pilot.SCADA\pilot.SCADA\pilot.SCADA\obj\Debug\Views\ConnectDBView.g.i.cs", "C#", 0, 78, 0, 0, 15, 17, 110
"e:\OneDrive\Gitee\pilot.SCADA\pilot.SCADA\pilot.SCADA\obj\Debug\Views\ConnectionSettingView.g.i.cs", "C#", 0, 122, 0, 0, 16, 35, 173
"e:\OneDrive\Gitee\pilot.SCADA\pilot.SCADA\pilot.SCADA\obj\Debug\Views\CreateSensorView.g.cs", "C#", 0, 104, 0, 0, 15, 27, 146
"e:\OneDrive\Gitee\pilot.SCADA\pilot.SCADA\pilot.SCADA\obj\Debug\Views\CreateSensorView.g.i.cs", "C#", 0, 104, 0, 0, 15, 27, 146
"e:\OneDrive\Gitee\pilot.SCADA\pilot.SCADA\pilot.SCADA\obj\Debug\Views\DataCheckView.g.cs", "C#", 0, 122, 0, 0, 15, 33, 170
"e:\OneDrive\Gitee\pilot.SCADA\pilot.SCADA\pilot.SCADA\obj\Debug\Views\DataCheckView.g.i.cs", "C#", 0, 122, 0, 0, 15, 33, 170
"e:\OneDrive\Gitee\pilot.SCADA\pilot.SCADA\pilot.SCADA\obj\Debug\Views\LogView.g.cs", "C#", 0, 80, 0, 0, 15, 18, 113
"e:\OneDrive\Gitee\pilot.SCADA\pilot.SCADA\pilot.SCADA\obj\Debug\Views\LogView.g.i.cs", "C#", 0, 80, 0, 0, 15, 18, 113
"e:\OneDrive\Gitee\pilot.SCADA\pilot.SCADA\pilot.SCADA\obj\Debug\Views\MainView.g.cs", "C#", 0, 112, 0, 0, 15, 30, 157
"e:\OneDrive\Gitee\pilot.SCADA\pilot.SCADA\pilot.SCADA\obj\Debug\Views\MainView.g.i.cs", "C#", 0, 112, 0, 0, 15, 30, 157
"e:\OneDrive\Gitee\pilot.SCADA\pilot.SCADA\pilot.SCADA\obj\Debug\Views\MainWindow.g.i.cs", "C#", 0, 49, 0, 0, 15, 12, 76
"e:\OneDrive\Gitee\pilot.SCADA\pilot.SCADA\pilot.SCADA\obj\Debug\Views\ModBusGuideView.g.cs", "C#", 0, 118, 0, 0, 15, 32, 165
"e:\OneDrive\Gitee\pilot.SCADA\pilot.SCADA\pilot.SCADA\obj\Debug\Views\ModBusGuideView.g.i.cs", "C#", 0, 118, 0, 0, 15, 32, 165
"e:\OneDrive\Gitee\pilot.SCADA\pilot.SCADA\pilot.SCADA\obj\Debug\Views\ModbusReadSetView.g.cs", "C#", 0, 78, 0, 0, 15, 17, 110
"e:\OneDrive\Gitee\pilot.SCADA\pilot.SCADA\pilot.SCADA\obj\Debug\Views\ModbusReadSetView.g.i.cs", "C#", 0, 78, 0, 0, 15, 17, 110
"e:\OneDrive\Gitee\pilot.SCADA\pilot.SCADA\pilot.SCADA\obj\Debug\Views\ModbusView.g.i.cs", "C#", 0, 73, 0, 0, 15, 15, 103
"e:\OneDrive\Gitee\pilot.SCADA\pilot.SCADA\pilot.SCADA\obj\Debug\Views\NewProjectView.g.cs", "C#", 0, 72, 0, 0, 15, 15, 102
"e:\OneDrive\Gitee\pilot.SCADA\pilot.SCADA\pilot.SCADA\obj\Debug\Views\NewProjectView.g.i.cs", "C#", 0, 72, 0, 0, 15, 15, 102
"e:\OneDrive\Gitee\pilot.SCADA\pilot.SCADA\pilot.SCADA\obj\Debug\Views\NodeConfigView.g.i.cs", "C#", 0, 88, 0, 0, 15, 21, 124
"e:\OneDrive\Gitee\pilot.SCADA\pilot.SCADA\pilot.SCADA\obj\Debug\Views\PluginView.g.cs", "C#", 0, 61, 0, 0, 15, 12, 88
"e:\OneDrive\Gitee\pilot.SCADA\pilot.SCADA\pilot.SCADA\obj\Debug\Views\PluginView.g.i.cs", "C#", 0, 61, 0, 0, 15, 12, 88
"e:\OneDrive\Gitee\pilot.SCADA\pilot.SCADA\pilot.SCADA\obj\Debug\Views\PrjItem.g.i.cs", "C#", 0, 49, 0, 0, 15, 12, 76
"e:\OneDrive\Gitee\pilot.SCADA\pilot.SCADA\pilot.SCADA\obj\Debug\Views\ProcessFlowManageView.g.i.cs", "C#", 0, 49, 0, 0, 15, 12, 76
"e:\OneDrive\Gitee\pilot.SCADA\pilot.SCADA\pilot.SCADA\obj\Debug\Views\ProjectManagView.g.cs", "C#", 0, 72, 0, 0, 15, 15, 102
"e:\OneDrive\Gitee\pilot.SCADA\pilot.SCADA\pilot.SCADA\obj\Debug\Views\ProjectManagView.g.i.cs", "C#", 0, 72, 0, 0, 15, 15, 102
"e:\OneDrive\Gitee\pilot.SCADA\pilot.SCADA\pilot.SCADA\obj\Debug\Views\RecentProjectView.g.i.cs", "C#", 0, 72, 0, 0, 15, 15, 102
"e:\OneDrive\Gitee\pilot.SCADA\pilot.SCADA\pilot.SCADA\obj\Debug\Views\RemoveSerialObjView.g.i.cs", "C#", 0, 78, 0, 0, 15, 21, 114
"e:\OneDrive\Gitee\pilot.SCADA\pilot.SCADA\pilot.SCADA\obj\Debug\Views\SelectTaskView.g.cs", "C#", 0, 88, 0, 0, 15, 21, 124
"e:\OneDrive\Gitee\pilot.SCADA\pilot.SCADA\pilot.SCADA\obj\Debug\Views\SelectTaskView.g.i.cs", "C#", 0, 88, 0, 0, 15, 21, 124
"e:\OneDrive\Gitee\pilot.SCADA\pilot.SCADA\pilot.SCADA\obj\Debug\Views\SensorManagerView.g.cs", "C#", 0, 80, 0, 0, 15, 18, 113
"e:\OneDrive\Gitee\pilot.SCADA\pilot.SCADA\pilot.SCADA\obj\Debug\Views\SensorManagerView.g.i.cs", "C#", 0, 80, 0, 0, 15, 18, 113
"e:\OneDrive\Gitee\pilot.SCADA\pilot.SCADA\pilot.SCADA\obj\Debug\Views\SerialComView.g.i.cs", "C#", 0, 111, 0, 0, 15, 30, 156
"e:\OneDrive\Gitee\pilot.SCADA\pilot.SCADA\pilot.SCADA\obj\Debug\Views\SerialView.g.i.cs", "C#", 0, 111, 0, 0, 15, 30, 156
"e:\OneDrive\Gitee\pilot.SCADA\pilot.SCADA\pilot.SCADA\obj\Debug\Views\TaskFlowManageView.g.i.cs", "C#", 0, 68, 0, 0, 15, 18, 101
"e:\OneDrive\Gitee\pilot.SCADA\pilot.SCADA\pilot.SCADA\obj\Debug\Views\TaskPreviewView.g.i.cs", "C#", 0, 72, 0, 0, 15, 15, 102
"e:\OneDrive\Gitee\pilot.SCADA\pilot.SCADA\pilot.SCADA\obj\Debug\Views\TaskProcessView.g.i.cs", "C#", 0, 60, 0, 0, 15, 15, 90
"e:\OneDrive\Gitee\pilot.SCADA\pilot.SCADA\pilot.SCADA\obj\Debug\Views\TaskView.g.cs", "C#", 0, 241, 0, 0, 15, 76, 332
"e:\OneDrive\Gitee\pilot.SCADA\pilot.SCADA\pilot.SCADA\obj\Debug\Views\TaskView.g.i.cs", "C#", 0, 241, 0, 0, 15, 76, 332
"e:\OneDrive\Gitee\pilot.SCADA\pilot.SCADA\pilot.SCADA\obj\Debug\Views\TestView.g.i.cs", "C#", 0, 80, 0, 0, 15, 18, 113
"e:\OneDrive\Gitee\pilot.SCADA\pilot.SCADA\pilot.SCADA\obj\Debug\Views\TiledCheckView.g.i.cs", "C#", 0, 109, 0, 0, 15, 33, 157
"e:\OneDrive\Gitee\pilot.SCADA\pilot.SCADA\pilot.SCADA\obj\Debug\Views\TiledItemView.g.cs", "C#", 0, 101, 0, 0, 15, 30, 146
"e:\OneDrive\Gitee\pilot.SCADA\pilot.SCADA\pilot.SCADA\obj\Debug\Views\TiledItemView.g.i.cs", "C#", 0, 101, 0, 0, 15, 30, 146
"e:\OneDrive\Gitee\pilot.SCADA\pilot.SCADA\pilot.SCADA\obj\Debug\Views\TiledView.g.cs", "C#", 0, 50, 0, 0, 15, 12, 77
"e:\OneDrive\Gitee\pilot.SCADA\pilot.SCADA\pilot.SCADA\obj\Debug\Views\TiledView.g.i.cs", "C#", 0, 50, 0, 0, 15, 12, 77
"e:\OneDrive\Gitee\pilot.SCADA\pilot.SCADA\pilot.SCADA\obj\Debug\Views\UserControl1.g.i.cs", "C#", 0, 49, 0, 0, 15, 12, 76
"e:\OneDrive\Gitee\pilot.SCADA\pilot.SCADA\pilot.SCADA\obj\Debug\Views\view1.g.i.cs", "C#", 0, 49, 0, 0, 15, 12, 76
"e:\OneDrive\Gitee\pilot.SCADA\pilot.SCADA\pilot.SCADA\obj\Debug\Views\view2.g.i.cs", "C#", 0, 70, 0, 0, 15, 14, 99
"e:\OneDrive\Gitee\pilot.SCADA\pilot.SCADA\pilot.SCADA\obj\Debug\pilot.HMS300_Content.g.i.cs", "C#", 0, 2, 0, 0, 8, 4, 14
"e:\OneDrive\Gitee\pilot.SCADA\pilot.SCADA\pilot.SCADA\obj\Debug\pilot.SCADA_Content.g.i.cs", "C#", 0, 3, 0, 0, 8, 4, 15
"e:\OneDrive\Gitee\pilot.SCADA\pilot.SCADA\pilot.SCADA\obj\Release\.NETFramework,Version=v4.7.2.AssemblyAttributes.cs", "C#", 0, 3, 0, 0, 1, 1, 5
"e:\OneDrive\Gitee\pilot.SCADA\pilot.SCADA\pilot.SCADA\obj\Release\App.g.cs", "C#", 0, 53, 0, 0, 18, 14, 85
"e:\OneDrive\Gitee\pilot.SCADA\pilot.SCADA\pilot.SCADA\obj\Release\App.g.i.cs", "C#", 0, 53, 0, 0, 18, 14, 85
"e:\OneDrive\Gitee\pilot.SCADA\pilot.SCADA\pilot.SCADA\obj\Release\GeneratedInternalTypeHelper.g.cs", "C#", 0, 1, 0, 0, 0, 2, 3
"e:\OneDrive\Gitee\pilot.SCADA\pilot.SCADA\pilot.SCADA\obj\Release\GeneratedInternalTypeHelper.g.i.cs", "C#", 0, 27, 0, 0, 26, 10, 63
"e:\OneDrive\Gitee\pilot.SCADA\pilot.SCADA\pilot.SCADA\obj\Release\Views\BluePrintView.g.cs", "C#", 0, 131, 0, 0, 15, 41, 187
"e:\OneDrive\Gitee\pilot.SCADA\pilot.SCADA\pilot.SCADA\obj\Release\Views\BluePrintView.g.i.cs", "C#", 0, 131, 0, 0, 15, 41, 187
"e:\OneDrive\Gitee\pilot.SCADA\pilot.SCADA\pilot.SCADA\obj\Release\Views\CheckValueView.g.cs", "C#", 0, 122, 0, 0, 15, 33, 170
"e:\OneDrive\Gitee\pilot.SCADA\pilot.SCADA\pilot.SCADA\obj\Release\Views\CheckValueView.g.i.cs", "C#", 0, 122, 0, 0, 15, 33, 170
"e:\OneDrive\Gitee\pilot.SCADA\pilot.SCADA\pilot.SCADA\obj\Release\Views\ConnectDBView.g.cs", "C#", 0, 78, 0, 0, 15, 17, 110
"e:\OneDrive\Gitee\pilot.SCADA\pilot.SCADA\pilot.SCADA\obj\Release\Views\ConnectDBView.g.i.cs", "C#", 0, 78, 0, 0, 15, 17, 110
"e:\OneDrive\Gitee\pilot.SCADA\pilot.SCADA\pilot.SCADA\obj\Release\Views\CreateSensorView.g.cs", "C#", 0, 104, 0, 0, 15, 27, 146
"e:\OneDrive\Gitee\pilot.SCADA\pilot.SCADA\pilot.SCADA\obj\Release\Views\CreateSensorView.g.i.cs", "C#", 0, 104, 0, 0, 15, 27, 146
"e:\OneDrive\Gitee\pilot.SCADA\pilot.SCADA\pilot.SCADA\obj\Release\Views\DataCheckView.g.cs", "C#", 0, 122, 0, 0, 15, 33, 170
"e:\OneDrive\Gitee\pilot.SCADA\pilot.SCADA\pilot.SCADA\obj\Release\Views\DataCheckView.g.i.cs", "C#", 0, 122, 0, 0, 15, 33, 170
"e:\OneDrive\Gitee\pilot.SCADA\pilot.SCADA\pilot.SCADA\obj\Release\Views\LogView.g.cs", "C#", 0, 80, 0, 0, 15, 18, 113
"e:\OneDrive\Gitee\pilot.SCADA\pilot.SCADA\pilot.SCADA\obj\Release\Views\LogView.g.i.cs", "C#", 0, 80, 0, 0, 15, 18, 113
"e:\OneDrive\Gitee\pilot.SCADA\pilot.SCADA\pilot.SCADA\obj\Release\Views\MainView.g.cs", "C#", 0, 112, 0, 0, 15, 30, 157
"e:\OneDrive\Gitee\pilot.SCADA\pilot.SCADA\pilot.SCADA\obj\Release\Views\MainView.g.i.cs", "C#", 0, 112, 0, 0, 15, 30, 157
"e:\OneDrive\Gitee\pilot.SCADA\pilot.SCADA\pilot.SCADA\obj\Release\Views\ModBusGuideView.g.cs", "C#", 0, 118, 0, 0, 15, 32, 165
"e:\OneDrive\Gitee\pilot.SCADA\pilot.SCADA\pilot.SCADA\obj\Release\Views\ModBusGuideView.g.i.cs", "C#", 0, 118, 0, 0, 15, 32, 165
"e:\OneDrive\Gitee\pilot.SCADA\pilot.SCADA\pilot.SCADA\obj\Release\Views\ModbusReadSetView.g.cs", "C#", 0, 78, 0, 0, 15, 17, 110
"e:\OneDrive\Gitee\pilot.SCADA\pilot.SCADA\pilot.SCADA\obj\Release\Views\ModbusReadSetView.g.i.cs", "C#", 0, 78, 0, 0, 15, 17, 110
"e:\OneDrive\Gitee\pilot.SCADA\pilot.SCADA\pilot.SCADA\obj\Release\Views\ModbusView.g.cs", "C#", 0, 73, 0, 0, 15, 15, 103
"e:\OneDrive\Gitee\pilot.SCADA\pilot.SCADA\pilot.SCADA\obj\Release\Views\ModbusView.g.i.cs", "C#", 0, 73, 0, 0, 15, 15, 103
"e:\OneDrive\Gitee\pilot.SCADA\pilot.SCADA\pilot.SCADA\obj\Release\Views\NewProjectView.g.cs", "C#", 0, 72, 0, 0, 15, 15, 102
"e:\OneDrive\Gitee\pilot.SCADA\pilot.SCADA\pilot.SCADA\obj\Release\Views\NewProjectView.g.i.cs", "C#", 0, 72, 0, 0, 15, 15, 102
"e:\OneDrive\Gitee\pilot.SCADA\pilot.SCADA\pilot.SCADA\obj\Release\Views\PrjItem.g.cs", "C#", 0, 49, 0, 0, 15, 12, 76
"e:\OneDrive\Gitee\pilot.SCADA\pilot.SCADA\pilot.SCADA\obj\Release\Views\PrjItem.g.i.cs", "C#", 0, 49, 0, 0, 15, 12, 76
"e:\OneDrive\Gitee\pilot.SCADA\pilot.SCADA\pilot.SCADA\obj\Release\Views\ProjectManagView.g.cs", "C#", 0, 72, 0, 0, 15, 15, 102
"e:\OneDrive\Gitee\pilot.SCADA\pilot.SCADA\pilot.SCADA\obj\Release\Views\ProjectManagView.g.i.cs", "C#", 0, 72, 0, 0, 15, 15, 102
"e:\OneDrive\Gitee\pilot.SCADA\pilot.SCADA\pilot.SCADA\obj\Release\Views\RecentProjectView.g.cs", "C#", 0, 72, 0, 0, 15, 15, 102
"e:\OneDrive\Gitee\pilot.SCADA\pilot.SCADA\pilot.SCADA\obj\Release\Views\RecentProjectView.g.i.cs", "C#", 0, 72, 0, 0, 15, 15, 102
"e:\OneDrive\Gitee\pilot.SCADA\pilot.SCADA\pilot.SCADA\obj\Release\Views\SensorManagerView.g.cs", "C#", 0, 80, 0, 0, 15, 18, 113
"e:\OneDrive\Gitee\pilot.SCADA\pilot.SCADA\pilot.SCADA\obj\Release\Views\SensorManagerView.g.i.cs", "C#", 0, 80, 0, 0, 15, 18, 113
"e:\OneDrive\Gitee\pilot.SCADA\pilot.SCADA\pilot.SCADA\obj\Release\Views\SerialComView.g.cs", "C#", 0, 111, 0, 0, 15, 30, 156
"e:\OneDrive\Gitee\pilot.SCADA\pilot.SCADA\pilot.SCADA\obj\Release\Views\SerialComView.g.i.cs", "C#", 0, 111, 0, 0, 15, 30, 156
"e:\OneDrive\Gitee\pilot.SCADA\pilot.SCADA\pilot.SCADA\obj\Release\Views\SerialView.g.cs", "C#", 0, 111, 0, 0, 15, 30, 156
"e:\OneDrive\Gitee\pilot.SCADA\pilot.SCADA\pilot.SCADA\obj\Release\Views\SerialView.g.i.cs", "C#", 0, 111, 0, 0, 15, 30, 156
"e:\OneDrive\Gitee\pilot.SCADA\pilot.SCADA\pilot.SCADA\obj\Release\Views\TaskView.g.cs", "C#", 0, 241, 0, 0, 15, 76, 332
"e:\OneDrive\Gitee\pilot.SCADA\pilot.SCADA\pilot.SCADA\obj\Release\Views\TaskView.g.i.cs", "C#", 0, 241, 0, 0, 15, 76, 332
"e:\OneDrive\Gitee\pilot.SCADA\pilot.SCADA\pilot.SCADA\obj\Release\Views\TiledCheckView.g.cs", "C#", 0, 109, 0, 0, 15, 33, 157
"e:\OneDrive\Gitee\pilot.SCADA\pilot.SCADA\pilot.SCADA\obj\Release\Views\TiledCheckView.g.i.cs", "C#", 0, 109, 0, 0, 15, 33, 157
"e:\OneDrive\Gitee\pilot.SCADA\pilot.SCADA\pilot.SCADA\obj\Release\Views\TiledItemView.g.cs", "C#", 0, 101, 0, 0, 15, 30, 146
"e:\OneDrive\Gitee\pilot.SCADA\pilot.SCADA\pilot.SCADA\obj\Release\Views\TiledItemView.g.i.cs", "C#", 0, 101, 0, 0, 15, 30, 146
"e:\OneDrive\Gitee\pilot.SCADA\pilot.SCADA\pilot.SCADA\obj\Release\Views\TiledView.g.cs", "C#", 0, 50, 0, 0, 15, 12, 77
"e:\OneDrive\Gitee\pilot.SCADA\pilot.SCADA\pilot.SCADA\obj\Release\Views\TiledView.g.i.cs", "C#", 0, 50, 0, 0, 15, 12, 77
"e:\OneDrive\Gitee\pilot.SCADA\pilot.SCADA\pilot.SCADA\obj\Release\Views\view2.g.cs", "C#", 0, 49, 0, 0, 15, 12, 76
"e:\OneDrive\Gitee\pilot.SCADA\pilot.SCADA\pilot.SCADA\obj\Release\Views\view2.g.i.cs", "C#", 0, 49, 0, 0, 15, 12, 76
"e:\OneDrive\Gitee\pilot.SCADA\pilot.SCADA\pilot.SCADA\pilot.SCADA.csproj", "XML", 594, 0, 0, 0, 0, 0, 594
"Total", "-", 218910, 13784, 11, 12, 2750, 4775, 240242